555555555555555
500000000000005
501010101010105
501010111010105
501010101010105
501010000010105
500000101000005
520110000011025
500000111000005
501010101010105
501010101010105
501010000010105
500000111000005
500000191000005
555555555555555