555555555555555
500020002000005
501020001010105
501000011012105
500010000020005
530010020013125
533000100203005
501113332003105
500023101010105
521020101010005
501000111012105
501000000000005
501000111010105
501010191011105
555555555555555