555555555555555
500000000001005
501440201000005
500441333440205
500000333441005
502004403000005
533104420000105
533300000020025
501440100000005
520443344330105
500003044334405
500023000334405
500100111000005
510000191012005
555555555555555